1111111111111111111111111111111111
1E00000C0001000C00000C000100000001
1100111100100000101001000100010101
1P110000101010100010010001000C0001
10100100101010100010010C0100010101
10100100101010100010010001000C0001
1010010010101010001001000100010101
1010001010101010001001000100010101
100001000C000000000000000010000C01
1111111111111111111111111111111111